1)ls путь - Содержимое директории
	-R показывает содержимое подкаталогов
	-l список каталогов и файлов в столбец
	-m вывод содержимого через запятую
	-a показать скрытые файлы
	-r в обратном порядке
	-t сортировка по времени
2)pwd отображает текущий путь.
3)cd путь - переместиться в текущую директорию
4)touch название.тип - создать пустой файл
5)mkdir название - создать папку
	-p k1/k2/k3/k4 создаст папку k1, в ней k2, в k2 k3...
6)cp название1 полный путь - команда копирования
	cp -R папка1 папка2 скопирует всю папку1 в папку 2
7)cat - показать содержимое файла
8)mv путь1/назв путь2/назв - перемещает файл
	mv назв1 назв2 - переименует
9)rm название - удалит файл
	-i запрашивает разрешение на удаление
10)rmdir название - удалит каталог(пустой)
	-R для удаления не пустого каталога	
	-f незапрашивать разрешение 
11)cat - вывести содержимое файла в консоль.
12)diff - сравнение двух файлов
	-q - выводить только отличия файлов;
	-s - выводить только совпадающие части;
	-с - выводить нужное количество строк после совпадений;
	-u - выводить только нужное количество строк после отличий;
	-y - выводить в две колонки;
	-e - вывод в формате ed скрипта;
	-n - вывод в формате RCS;
	-a - сравнивать файлы как текстовые, даже если они не текстовые;
	-t - заменить табуляции на пробелы в выводе;
	-l - разделить на страницы и добавить поддержку листания;
	-r - рекурсивное сравнение папок;
	-i - игнорировать регистр;
	-E - игнорировать изменения в табуляциях;
	-Z - не учитывать пробелы в конце строки;
	-b - не учитывать пробелы;
	-B - не учитывать пустые строки.
